# Pedestrian: 'p' or 'P'
# Empty cell: '.'
# Wall: 'w' or 'W'
# Exit: 'x' or 'X'

dimension: 40
map:
WWWWWWWWWWWWWWWWWWWxxWWWWWWWWWWWWWWWWWWW
W...p...p......p..p......p.............W
W......p..p..........p...p.p...p.......W
W...............p..pp....p.............W
W..p...p......p..........p....p....p...W
W........p........................p.p..W
W........pp........p...................W
W...p.......pp..p.p......pp.....p......W
W......p..p.pp...p.p..p............p.p.W
W........p..................p.p.p.p....W
W................p......p....p.p.pp....W
W..p...pp.pp...p.....p........p..pp.p..W
W.p.................p............p.....W
Wp........p.p....pp.p....p.............W
Wp.ppp........p...p...p...p......p.....W
W................................ppp...W
W....p...p.........p.....p.............W
W.....p.......pppp.......p...........p.W
W....pp......................p.p.......W
W.p....p.......p....p..................W
Wp....p..............p....p.p...p......W
Wp....p...pp.....p.....................W
W..p.........p..........p........pp....W
Wp..........p..............p.........p.W
W..p.............p................p....W
Wp.......p..............ppp.......p...pW
W...........p......p.....p...........ppW
Wp.......p.....p....................p..W
W.....p.......p..p.......p.............W
Wp...p....p...................p....p..pW
Wp......pp....................p.p...pp.W
W.......p.........p...................pW
W.....p..p.........pp.....pp...p.......W
W.p.p.....p..p.......p.................W
W...........p..........................W
W.............p........p........p......W
W.....ppp...p...p............p...p.....W
W....p...p..................p..........W
W....p...........p.........p.p.....p...W
WWWWWWWWWWWWWWWWWWWWWWWWWWWWWWWWWWWWWWWW