# Pedestrian: 'p' or 'P'
# Empty cell: '.'
# Wall: 'w' or 'W'
# Exit: 'x' or 'X'

dimension: 16
map:
.........p.W..XX
........pppW...X
......ppp.pW....
.....p.ppp.W....
.......WWWWW....
.......pp.pp....
.......W...W....
.......WWWWW....
................
....WWWWW.......
....W.pp........
....Wp.pp.......
....W.pp........
....W...........
X...............
XX..............
