# Pedestrian: 'p' or 'P'
# Empty cell: '.'
# Wall: 'w' or 'W'
# Exit: 'x' or 'X'

dimension: 16
map:
.........p....XX
........ppp....X
.p....ppp.p.....
.pp..p.ppp......
..ppp...........
...pp..pp.pp....
.......p.p......
..p..p..p..pp...
......p..p..p...
..p.pp...pp.....
......pp..p.p...
.....p.pp..p.p..
..p.p.pp........
..p...p....p....
X.........p.....
XX..............
